1111111111111111111111111111111111
1E0000000000000C00000C000000000001
10100101001000001V1001000000010101
101001001010101000100100000001V101
1P0000000C00C00000000000V0000000C1
1111111111111111111111111111111111