1111111111111
10010000V00C1
1V0V011111001
1P0V11E000V01
1111111111111